............#..........#.#..#.#..#................................................#........#...#.....
......#......#...............#..#..........................#.....##..#.........##....................
#...##...#.#....#...........#.....#.......#.....#..........#...........#..##.........................
......#...#..#...............#.#...........#....##..#.....#.#.#.#.#...........#..#...................
...#...#...#.....##...#............#......#.#.#.................#........#.......................#...
....#.....#............#......#....................#........#.......#..#.........#....#.............#
.#..........#.#.....##.....#......#........##......#.......#.#....#............#.....#.##.......#....
..#..........#.........#.......#.#..#......#....##.....#.........#.........#..#.............##...#...
.................#...............#.....##.#..................#......................#....#......#..#.
..##.##.#..........#....#.#.#........#.............#......##..#....#........#.#.......#.#.#..........
.#................#............#.......#....#......#............#...............#....................
....#.#............#..#.....#.#.....................#.#.................#..#..........#..............
.#.......#........#....#...#.#..#...#.....#....#...........##....................#.......#...#.....#.
......#.........#..#.......#.#..#..............#....................#.#....#.#.....#....#..#..##.....
..#.#..#..#..........................##..##......................#...##........#......#.......#..#...
#..#................#....#.#.....................#...#...#.#.#...#.....#........#..................#.
..........#...#....#.#.#..#......#.#.....#..#...........#...#......#..##...#.........#...........#.#.
..#.......#.............#...#.....#............#.......#......#.....#.#..................#...........
...##....#..###...#.#..#..#..........#....#......#..###.......................#.......#.#......#....#
..#................#..................#.........#.......#....#..#...#..................#......#.#....
.#.#.....#................#.##...#....#.#.#....#....#..#.......................#.#....#..#...........
..#.............##............##...............#..........#..#...................#....#.....#........
...#...............................#......#.........#...#...#..#...........#.......#..#......#.#.....
......##....#.#.#.....##...#.........#........#...#.........#...#............#....................#..
..#..#...........#......#.#...........#..........#....#..#.#......#......#.....#.#.#.......#.....#...
.#............#..#.........#...........#.............................#.....#.........#.............#.
....#......#.....#...##.....#...#..##............#...#.........#.......#.#..............##..#.#.#.#..
....#..#..#........#..........#.......#.....#............##....#...........#.#......#.....#......#...
.#.......#........#.........#.............#........#...........#........#.............#.......#.....#
#..................#...#............#.......#......#..#.....#...#.#........#.#.#.#.......#......#.#..
..#..#...#.....#......#..........#........#....##....#..#....#.#......#......#..###...#........#.#...
#...#..#...........#.....###.#..........#.#...#....#...........#.....#..##....#.....#..#...#.##.....#
.#.....#........#...#.............#......#.#.......................#....#..#.......##..........#.....
......#...#..........................................#.......#..............#.#......#...............
...#...............#.........#.............#...#............#...................##.#..........#......
..#......................#......#.............#.......##..................#.....#...........#.#.#....
........#................#....#........#..#.....#...#.#...................##.#.#...........#..#...#..
........................#....#.....#......#..#................................#..#..#.#..............
.......#..#...#....#.#......................#......#.........................#.......#..#..#...#.....
..#.....#...#.......#...........................#...#..............#...#.....#.....#...#.##..#.......
..........#......#.#........#..........#.............#.....#.#.......#...###...#..#.........#.......#
............#..#..............##...#........##......................#............#..#......#.........
#..#..........#..#.....###..#....#....#.....#.......#..................#.......#...#.................
.#......##.#.........#........##........#.#....#....#.#......#.##................#............#...#.#
....##..........#.#.........................#.................#.................#.........#...#.#....
...#.................#........#..#............#.#..#..#..................#......#...##...#.......#.#.
.#.....#......#.............#..........#..#....#..............#..............#.#......#..............
...........#.........#....#.............#...#.....#.......##.#.....#....#....#.....#.#......#........
....#.....#.#......#.......................#...#..#....#..............#......#.............#........#
...#........#.......#....#...#.............#...#........#.......#......#..#............#....#........
..#.##...#....#.#.#.....#...##...#...#.....#.#.......#....#..#......#...........#.#...#..#.....#.....
...............#.#...............#...........#.....#.#....................#...#.....##.........##....
.......#....#...#......#..#.#.......................#......#.......#...#.....#.............#....##...
#.#...#........#..........#..#.....#.#.........#..#...#..#...#....##...#...#..#..#....#...#........#.
..........#.#....#....#..#..#...........#...#....#...#..............................#....#..#........
#.........#........#..................#.#.#.......#....#.............#........#......................
.....#..............#.....#..#.......#..............#...................#.........#.#..#.#.#.##....#.
...#............#..............................#.#..........#..............#.....##..................
..#....#.......#..#...........#.......................#..#...#.#...........#..............##..#......
.#.........#..#.#...........#..#.....#.......##..........................#......#................#..#
...........#..##.....#...#....#...#...#....#........#....#..#.#.#.......................#..#.......#.
...#...#........................#.##.....#......#..........#.....#.#.......#......#.#.....#.#.#.#....
.#..#.........#..#......#.#....#..#...#....#...#............#......#......#..#.......................
##...........#.#......##....#.....#........................#......#...#.##...#........##.....###.....
.................##.#...#..#.....#..........#......#..##...........#....#.##........##..........#....
.#.#..#.#....................#..........#........#...............##..............#.......#......#....
#.....................#.....#..#.....#........#...................#.#.#....#....................#....
.............#......#......#.#...........#.........#.....#............#........#............#....#.#.
.......##.....#....#..#.#.#........#....#......#............#.#.........##.#.....................#.#.
..##........................#..........#..........#.#.............................#.....#.#...##.....
..#.........#.......#............................#...........#............#.............#....#.......
.............#.....#...#......##.#.##....##.........##.........#.#......#........#....#.......#......
.#........#...........#.....................#...#............#....#...#.................##......#....
....#.#.#...##....#.....##......#.........#...#.....................#..............#..........#.#...#
..............................................................#.................#.......#.........#..
..........................#..............##......#....#......#...........##..#....#..#............#..
...#....#.#..#.#............#........#....................#........#...#..#.....................#..#.
...#.#.#......#......#...##..#............#...#........#....................#........#.....###...#.#.
#..........#.#...#.#..........#.............#....#..#.....#.#.#.........##..#......#...#.....#.......
............#........#.....#...#.........##....#..............#.##.##.........#...............#......
#.........#.......#....#........................#.#...#.......#.#..#..............#......#...........
....#...#.#......#......#...............#..........#...#..#....#......#....#.#...#...#..#.##..##.....
.......#.#....#...................#..#......#........#.#.........#.....#........#....................
..#.#.#..............#..#.....#.....#......#.#.......#...................#.......#........#.......##.
.#...........##.........#.................#.......#............#.........#.....#...#...#.............
.............................#................#..........#.............#...........#............#.#.#
....##.....#...#.#................#.#..............#.....#....#......#......#...........#.#..#..#....
#....#....#..#....##....#...#.............##.#....#......................#....#.#..................#.
.#.......................#...#................#.....#....#.......#...#............#..#.#.#..........#
....#....#............#...##..............##.#.#..#.............#.....#........#............##.#.....
...#..................#...#.#..#..#.................##.#......#.....#.....#.#.......#..#...#....#....
..............#.#............#.........#...........#......#.......#..#..........#........#....#...#..
.........#..............#............#................#......#...........#..............#........#...
#.............#.#......#.....#.....##............#.#....#...........#...#.#.......##..#....#.....##.#
.........#...#.#...#...#....#.........#.#......#.......#.......#...................#...........#.....
.#............#.#................#..#.......#...................#........................#......#....
.#.......##..#...........#......#..#...#....#.........#..#...#.#....#.....#........#................#
#.....................#......#...........#.......................#........#..................#.#.....
#...#..............#..........#........#..........#...#....#....#...#...............#...##...........
#..#.......................##..##.........#.......#......#....#....#.#.........#....#....#.....#...#.
.#..##...##.............#........#...........#..#...#....#....#.........#...#....#.....#......#....#.
